	1 6 3 1 7 1 1 5 1 4 1 1 1 1 1 3 1 1 1 1 1 1 1 1
	1 0 0 0 0 0 0 0 7 0 0 0 1 0 0 0 0 0 0 0 0 0 0 1
	4 0 0 0 0 0 1 0 2 0 0 0 8 1 0 1 1 1 1 1 1 0 1 1
	1 1 1 1 1 0 1 0 1 0 0 0 1 0 0 0 0 0 0 0 0 0 0 1
	1 0 0 0 0 0 1 0 1 1 1 1 1 0 1 0 0 1 1 1 1 0 1 1
	5 0 1 1 1 0 1 0 0 0 0 0 0 0 1 0 0 5 0 0 1 0 0 1
	1 0 1 0 0 0 1 0 0 1 1 1 1 1 0 0 0 1 0 0 1 0 1 1
	1 0 1 0 1 0 1 0 0 9 0 0 0 1 0 0 0 1 0 0 1 0 0 1
	8 0 1 0 1 1 1 1 1 1 0 0 0 1 0 0 0 1 1 3 1 0 1 1
	1 0 1 1 1 0 1 0 0 0 0 1 1 1 0 0 0 0 0 0 0 0 0 1
	9 0 0 0 0 0 1 0 0 0 1 0 0 0 0 0 0 0 0 0 0 0 0 3
	1 1 1 6 1 0 0 0 0 1 0 0 0 0 0 1 0 0 0 1 1 1 0 1
	3 0 0 0 0 0 0 0 0 1 0 0 0 0 0 1 0 0 0 0 0 1 0 7
	1 0 0 0 0 1 0 0 0 1 0 0 0 0 0 1 0 0 0 0 0 1 0 1
	1 0 0 0 0 1 1 0 0 0 1 0 0 0 1 0 0 0 0 0 0 1 0 4
	1 0 0 0 0 0 1 0 0 0 0 1 1 0 0 0 0 0 0 0 0 1 0 1
	6 0 0 0 0 0 1 3 1 1 0 1 0 0 0 0 0 0 0 0 0 0 0 1
	1 0 0 0 0 0 1 0 0 1 0 1 0 0 0 9 7 5 1 0 0 0 0 1
	1 1 1 1 0 0 1 0 0 1 0 1 1 1 1 0 0 0 0 1 1 1 0 1
	1 0 0 0 0 0 1 0 0 1 0 0 1 0 0 0 0 0 0 0 0 3 0 1
	1 1 7 1 0 0 1 1 1 1 0 0 1 0 1 1 0 0 0 0 0 1 0 1
	1 1 1 1 0 0 0 0 0 0 0 0 1 0 1 0 0 1 0 1 1 1 0 1
	3 0 0 0 0 0 0 0 0 0 0 0 0 0 1 0 0 1 0 0 0 0 0 1
	1 1 1 7 4 3 1 1 1 1 1 1 1 1 1 1 1 1 1 1 1 1 3 1